1,1,1,1,1,1,1,1,1,1,1,1,1,1,1,1,1,1,1,0,0,1,1,1,1,1,1,1,1,1,1,1,1,1,1,1,1,1,1,1
1,18,18,18,18,18,18,18,18,18,18,18,18,18,18,18,18,18,18,18,18,18,18,18,18,18,18,18,18,18,18,18,18,18,18,18,18,18,17,1
1,12,13,12,12,12,13,12,12,12,13,12,12,12,12,12,12,12,12,13,12,12,12,12,13,12,13,13,12,12,12,13,12,12,13,12,13,12,16,1
1,12,13,12,13,13,12,14,12,12,13,12,12,13,12,13,13,12,12,12,13,12,13,12,12,12,12,13,13,12,12,13,12,12,13,12,12,12,16,1
1,12,12,12,14,12,12,13,12,12,12,13,12,12,12,12,12,13,13,12,13,12,12,12,13,12,12,14,13,12,12,13,12,12,12,12,13,12,16,1
1,12,13,14,13,12,12,12,13,12,12,14,13,12,13,13,12,13,12,12,12,12,12,13,13,13,12,12,13,12,14,13,12,13,12,12,13,12,16,1
1,12,13,12,12,13,12,12,13,12,14,12,12,12,12,12,12,12,12,12,12,12,12,12,12,12,13,12,12,12,14,12,13,13,14,12,12,12,16,1
1,22,22,22,22,22,22,22,22,22,22,22,22,22,22,22,22,22,22,22,22,22,22,22,13,12,13,12,13,12,12,12,13,12,12,13,13,12,16,1
1,1,1,1,1,1,1,1,1,1,1,1,1,1,1,1,1,1,1,1,1,1,1,1,20,12,12,12,12,13,13,12,12,14,12,14,12,12,16,1
1,0,0,0,0,0,0,0,0,0,0,0,0,0,0,0,0,0,0,0,0,0,0,1,20,12,12,13,12,13,12,14,12,13,13,12,12,14,16,1
1,0,0,0,0,0,0,0,0,0,0,0,0,0,0,0,0,0,0,0,0,0,0,1,20,12,13,13,12,12,12,13,12,12,12,14,12,12,16,1
0,0,0,0,0,0,0,0,0,0,0,0,0,0,0,0,0,0,0,0,0,0,0,1,20,12,12,12,12,13,12,13,13,12,13,12,12,12,16,0
0,0,0,0,0,0,0,0,0,0,0,0,0,0,0,0,0,0,0,0,0,0,0,1,20,12,13,12,12,13,12,12,13,12,12,12,12,12,16,0
1,0,0,0,0,0,0,0,0,0,0,0,0,0,0,0,0,0,0,0,0,0,0,1,20,12,12,12,12,12,12,12,14,14,12,12,12,12,16,1
1,0,0,0,0,0,0,0,0,0,0,0,0,0,0,0,0,0,0,0,0,0,0,1,20,12,12,14,12,12,13,13,12,14,12,14,13,12,16,1
1,1,1,1,1,1,1,1,1,1,1,1,1,1,1,1,1,0,0,0,0,0,0,1,20,12,12,13,12,12,14,12,14,12,12,12,12,13,16,1
1,18,18,18,18,18,18,18,18,18,18,18,18,18,18,17,1,0,0,0,0,0,0,1,20,12,14,12,12,12,12,12,12,13,12,12,12,12,16,1
1,12,12,14,12,12,13,12,12,13,12,14,12,13,12,16,1,0,0,0,0,0,0,1,20,12,14,13,12,12,13,13,13,12,13,12,14,12,16,1
1,13,12,12,14,12,12,12,13,12,14,12,12,12,14,16,1,0,0,0,0,0,0,1,20,12,12,12,14,13,12,12,13,14,12,12,13,12,16,1
1,14,13,12,12,12,14,14,12,12,13,12,12,13,13,16,1,0,0,0,0,0,0,1,20,12,12,14,14,12,14,12,12,13,12,13,13,12,16,1
1,13,12,12,14,13,12,12,12,12,14,13,13,12,12,16,1,0,0,0,0,0,0,1,20,14,13,14,12,12,14,12,12,14,12,14,12,13,16,1
1,14,13,12,14,13,12,14,13,12,12,13,12,12,13,16,1,0,0,0,0,0,0,1,20,13,12,12,12,13,12,12,12,12,13,12,12,13,16,1
1,12,13,12,13,13,12,12,14,12,13,12,13,12,13,16,1,0,0,0,0,0,0,1,20,13,12,12,13,12,13,12,12,13,12,12,13,12,16,1
1,1,1,1,1,1,1,1,1,1,1,1,1,1,1,1,1,1,1,0,0,1,1,1,1,1,1,1,1,1,1,1,1,1,1,1,1,1,1,1
